AatII	GACGTC	PALINDROME
Acc65I	GGTACC	PALINDROME
AclI	AACGTT	PALINDROME
AfeI	AGCGCT	PALINDROME
AflII	CTTAAG	PALINDROME
AgeI	ACCGGT	PALINDROME
AluI	AGCT	PALINDROME
ApaI	GGGCCC	PALINDROME
ApaLI	GTGCAC	PALINDROME
AscI	GGCGCGCC	PALINDROME
AseI	ATTAAT	PALINDROME
AsiSI	GCGATCGC	PALINDROME
AvrII	CCTAGG	PALINDROME
BamHI	GGATCC	PALINDROME
BclI	TGATCA	PALINDROME
BfaI	CTAG	PALINDROME
BfuCI	GATC	PALINDROME
BglII	AGATCT	PALINDROME
BmtI	GCTAGC	PALINDROME
BsiWI	CGTACG	PALINDROME
BspDI	ATCGAT	PALINDROME
BspEI	TCCGGA	PALINDROME
BspHI	TCATGA	PALINDROME
BsrGI	TGTACA	PALINDROME
BssHII	GCGCGC	PALINDROME
BstBI	TTCGAA	PALINDROME
BstUI	CGCG	PALINDROME
BstZ17I	GTATAC	PALINDROME
ClaI	ATCGAT	PALINDROME
CviAII	CATG	PALINDROME
CviQI	GTAC	PALINDROME
DpnI	GATC	PALINDROME
DpnII	GATC	PALINDROME
DraI	TTTAAA	PALINDROME
EagI	CGGCCG	PALINDROME
Eco53kI	GAGCTC	PALINDROME
EcoRI	GAATTC	PALINDROME
EcoRV	GATATC	PALINDROME
FatI	CATG	PALINDROME
FseI	GGCCGGCC	PALINDROME
FspI	TGCGCA	PALINDROME
HaeIII	GGCC	PALINDROME
HhaI	GCGC	PALINDROME
HindIII	AAGCTT	PALINDROME
HinP1I	GCGC	PALINDROME
HpaI	GTTAAC	PALINDROME
HpaII	CCGG	PALINDROME
HpyCH4IV	ACGT	PALINDROME
HpyCH4V	TGCA	PALINDROME
KasI	GGCGCC	PALINDROME
KpnI	GGTACC	PALINDROME
MboI	GATC	PALINDROME
MfeI	CAATTG	PALINDROME
MluCI	AATT	PALINDROME
MluI	ACGCGT	PALINDROME
MscI	TGGCCA	PALINDROME
MseI	TTAA	PALINDROME
MspI	CCGG	PALINDROME
NaeI	GCCGGC	PALINDROME
NarI	GGCGCC	PALINDROME
NcoI	CCATGG	PALINDROME
NdeI	CATATG	PALINDROME
NgoMIV	GCCGGC	PALINDROME
NheI	GCTAGC	PALINDROME
NlaIII	CATG	PALINDROME
NotI	GCGGCCGC	PALINDROME
NruI	TCGCGA	PALINDROME
NsiI	ATGCAT	PALINDROME
PacI	TTAATTAA	PALINDROME
PaeR7I	CTCGAG	PALINDROME
PciI	ACATGT	PALINDROME
PhoI	GGCC	PALINDROME
PluTI	GGCGCC	PALINDROME
PmeI	GTTTAAAC	PALINDROME
PmlI	CACGTG	PALINDROME
PsiI	TTATAA	PALINDROME
PspOMI	GGGCCC	PALINDROME
PstI	CTGCAG	PALINDROME
PvuI	CGATCG	PALINDROME
PvuII	CAGCTG	PALINDROME
RsaI	GTAC	PALINDROME
SacI	GAGCTC	PALINDROME
SacII	CCGCGG	PALINDROME
SalI	GTCGAC	PALINDROME
Sau3AI	GATC	PALINDROME
SbfI	CCTGCAGG	PALINDROME
ScaI	AGTACT	PALINDROME
SfoI	GGCGCC	PALINDROME
SmaI	CCCGGG	PALINDROME
SnaBI	TACGTA	PALINDROME
SpeI	ACTAGT	PALINDROME
SphI	GCATGC	PALINDROME
SrfI	GCCCGGGC	PALINDROME
SspI	AATATT	PALINDROME
StuI	AGGCCT	PALINDROME
SwaI	ATTTAAAT	PALINDROME
TaqI	TCGA	PALINDROME
TliI	CTCGAG	PALINDROME
Tsp509I	AATT	PALINDROME
TspMI	CCCGGG	PALINDROME
XbaI	TCTAGA	PALINDROME
XhoI	CTCGAG	PALINDROME
XmaI	CCCGGG	PALINDROME
ZraI	GACGTC	PALINDROME
TaiI	ACGT	PALINDROME
AciI	CCGC	GCGG
AcuI	CTGAAG	CTTCAG
AlwI	GGATC	GATCC
BbsI	GAAGAC	GTCTTC
BbvCI	CCTCAGC	GCTGAGG
BbvI	GCAGC	GCTGC
BccI	CCATC	GATGG
BceAI	ACGGC	GCCGT
BciVI	GTATCC	GGATAC
BcoDI	GTCTC	GAGAC
BfuAI	ACCTGC	GCAGGT
BmgBI	CACGTC	GACGTG
BmrI	ACTGGG	CCCAGT
BpmI	CTGGAG	CTCCAG
BpuEI	CTTGAG	CTCAAG
BsaI	GGTCTC	GAGACC
BseRI	GAGGAG	CTCCTC
BseYI	CCCAGC	GCTGGG
BsgI	GTGCAG	CTGCAC
BsmAI	GTCTC	GAGAC
BsmBI	CGTCTC	GAGACG
BsmFI	GGGAC	GTCCC
BsmI	GAATGC	GCATTC
BspCNI	CTCAG	CTGAG
BspMI	ACCTGC	GCAGGT
BspQI	GCTCTTC	GAAGAGC
BsrBI	CCGCTC	GAGCGG
BsrDI	GCAATG	CATTGC
BsrI	ACTGG	CCAGT
BssSI	CACGAG	CTCGTG
BtgZI	GCGATG	CATCGC
BtsCI	GGATG	CATCC
BtsI	GCAGTG	CACTGC
BtsIMutI	CAGTG	CACTG
EarI	CTCTTC	GAAGAG
EciI	GGCGGA	TCCGCC
EcoP15I	CAGCAG	CTGCTG
FauI	CCCGC	GCGGG
FokI	GGATG	CATCC
FspEI	CC	GG
HgaI	GACGC	GCGTC
HphI	GGTGA	TCACC
HpyAV	CCTTC	GAAGG
I-CeuI	TAACTATAACGGTCCTAAGGTAGCGAA	TTCGCTACCTTAGGACCGTTATAGTTA
I-SceI	TAGGGATAACAGGGTAAT	ATTACCCTGTTATCCCTA
MboII	GAAGA	TCTTC
MlyI	GAGTC	GACTC
MnlI	CCTC	GAGG
Nb.BbvCI	CCTCAGC	GCTGAGG
Nb.BsmI	GAATGC	GCATTC
Nb.BtsI	GCAGTG	CACTGC
NmeAIII	GCCGAG	CTCGGC
Nt.AlwI	GGATC	GATCC
Nt.BbvCI	CCTCAGC	GCTGAGG
Nt.BsmAI	GTCTC	GAGAC
Nt.BspQI	GCTCTTC	GAAGAGC
Nt.BstNBI	GAGTC	GACTC
PI-PspI	TGGCAAACAGCTATTATGGGTATTATGGGT	ACCCATAATACCCATAATAGCTGTTTGCCA
PI-SceI	ATCTATGTCGGGTGCGGAGAAAGAGGTAAT	ATTACCTCTTTCTCCGCACCCGACATAGAT
PleI	GAGTC	GACTC
SapI	GCTCTTC	GAAGAGC
SfaNI	GCATC	GATGC
BseMII	CTCAG	CTGAG
TaqII	GACCGA	TCGGTC
TspDTI	ATGAA	TTCAT
TspGWI	ACGGA	TCCGT
ApeKI	GC[AT]GC	PALINDROME
AvaII	GG[AT]CC	PALINDROME
BstNI	CC[AT]GG	PALINDROME
Hpy99I	CG[AT]CG	PALINDROME
NciI	CC[CG]GG	PALINDROME
PspGI	CC[AT]GG	PALINDROME
RsrII	CGG[AT]CCG	PALINDROME
SexAI	ACC[AT]GGT	PALINDROME
TfiI	GA[AT]TC	PALINDROME
TseI	GC[AT]GC	PALINDROME
Tsp45I	GT[CG]AC	PALINDROME
TauI	GC[CG]GC	PALINDROME
MmeI	TCC[AG]AC	GT[CT]GGA
AccI	GT[AC][GT]AC	PALINDROME
AflIII	AC[AG][CT]GT	PALINDROME
ApoI	[AG]AATT[CT]	PALINDROME
AvaI	C[CT]CG[AG]G	PALINDROME
BaeGI	G[GT]GC[AC]C	PALINDROME
BanI	GG[CT][AG]CC	PALINDROME
BanII	G[AG]GC[CT]C	PALINDROME
BlpI	GCT[ACGT]AGC	PALINDROME
BsaAI	[CT]ACGT[AG]	PALINDROME
BsaHI	G[AG]CG[CT]C	PALINDROME
BsaWI	[AT]CCGG[AT]	PALINDROME
BsiEI	CG[AG][CT]CG	PALINDROME
BsiHKAI	G[AT]GC[AT]C	PALINDROME
BsoBI	C[CT]CG[AG]G	PALINDROME
BsrFI	[AG]CCGG[CT]	PALINDROME
BssKI	CC[ACGT]GG	PALINDROME
BstEII	GGT[ACGT]ACC	PALINDROME
BstYI	[AG]GATC[CT]	PALINDROME
Bsu36I	CCT[ACGT]AGG	PALINDROME
BtgI	CC[AG][CT]GG	PALINDROME
CviKI-1	[AG]GC[CT]	PALINDROME
DdeI	CT[ACGT]AG	PALINDROME
EaeI	[CT]GGCC[AG]	PALINDROME
Fnu4HI	GC[ACGT]GC	PALINDROME
HaeII	[AG]GCGC[CT]	PALINDROME
HincII	GT[CT][AG]AC	PALINDROME
HinfI	GA[ACGT]TC	PALINDROME
Hpy188I	TC[ACGT]GA	PALINDROME
HpyCH4III	AC[ACGT]GT	PALINDROME
MspA1I	C[AC]GC[GT]G	PALINDROME
NspI	[AG]CATG[CT]	PALINDROME
Sau96I	GG[ACGT]CC	PALINDROME
ScrFI	CC[ACGT]GG	PALINDROME
SfcI	CT[AG][CT]AG	PALINDROME
SgrAI	C[AG]CCGG[CT]G	PALINDROME
SmlI	CT[CT][AG]AG	PALINDROME
StyD4I	CC[ACGT]GG	PALINDROME
StyI	CC[AT][AT]GG	PALINDROME
BlsI	GC[ACGT]GC	PALINDROME
Bme1580I	G[GT]GC[AC]C	PALINDROME
TatI	[AT]GTAC[AT]	PALINDROME
LpnPI	CC[AGT]G	C[ACT]GG
Nt.CviPII	CC[AGT]	[ACT]GG
Bpu10I	CCT[ACGT]AGC	GCT[ACGT]AGG
PpuMI	[AG]GG[AT]CC[CT]	PALINDROME
Bsp1286I	G[AGT]GC[ACT]C	PALINDROME
PspXI	[ACG]CTCGAG[CGT]	PALINDROME
BsaJI	CC[ACGT][ACGT]GG	PALINDROME
Cac8I	GC[ACGT][ACGT]GC	PALINDROME
EcoO109I	[AG]GG[ACGT]CC[CT]	PALINDROME
Hpy166II	GT[ACGT][ACGT]AC	PALINDROME
Hpy188III	TC[ACGT][ACGT]GA	PALINDROME
NlaIV	GG[ACGT][ACGT]CC	PALINDROME
MspJI	C[ACGT][ACGT][AG]	[CT][ACGT][ACGT]G
AlwNI	CAG[ACGT][ACGT][ACGT]CTG	PALINDROME
DraIII	CAC[ACGT][ACGT][ACGT]GTG	PALINDROME
PflFI	GAC[ACGT][ACGT][ACGT]GTC	PALINDROME
Tth111I	GAC[ACGT][ACGT][ACGT]GTC	PALINDROME
AleI	CAC[ACGT][ACGT][ACGT][ACGT]GTG	PALINDROME
BsaBI	GAT[ACGT][ACGT][ACGT][ACGT]ATC	PALINDROME
PshAI	GAC[ACGT][ACGT][ACGT][ACGT]GTC	PALINDROME
XmnI	GAA[ACGT][ACGT][ACGT][ACGT]TTC	PALINDROME
TspRI	[ACGT][ACGT]CA[CG]TG[ACGT][ACGT]	PALINDROME
BaeI	AC[ACGT][ACGT][ACGT][ACGT]GTA[CT]C	G[AG]TAC[ACGT][ACGT][ACGT][ACGT]GT
AhdI	GAC[ACGT][ACGT][ACGT][ACGT][ACGT]GTC	PALINDROME
BglI	GCC[ACGT][ACGT][ACGT][ACGT][ACGT]GGC	PALINDROME
BstAPI	GCA[ACGT][ACGT][ACGT][ACGT][ACGT]TGC	PALINDROME
EcoNI	CCT[ACGT][ACGT][ACGT][ACGT][ACGT]AGG	PALINDROME
MslI	CA[CT][ACGT][ACGT][ACGT][ACGT][AG]TG	PALINDROME
PflMI	CCA[ACGT][ACGT][ACGT][ACGT][ACGT]TGG	PALINDROME
SfiI	GGCC[ACGT][ACGT][ACGT][ACGT][ACGT]GGCC	PALINDROME
BsaXI	AC[ACGT][ACGT][ACGT][ACGT][ACGT]CTCC	GGAG[ACGT][ACGT][ACGT][ACGT][ACGT]GT
CspCI	CAA[ACGT][ACGT][ACGT][ACGT][ACGT]GTGG	CCAC[ACGT][ACGT][ACGT][ACGT][ACGT]TTG
BstXI	CCA[ACGT][ACGT][ACGT][ACGT][ACGT][ACGT]TGG	PALINDROME
DrdI	GAC[ACGT][ACGT][ACGT][ACGT][ACGT][ACGT]GTC	PALINDROME
BcgI	CGA[ACGT][ACGT][ACGT][ACGT][ACGT][ACGT]TGC	GCA[ACGT][ACGT][ACGT][ACGT][ACGT][ACGT]TCG
BslI	CC[ACGT][ACGT][ACGT][ACGT][ACGT][ACGT][ACGT]GG	PALINDROME
MwoI	GC[ACGT][ACGT][ACGT][ACGT][ACGT][ACGT][ACGT]GC	PALINDROME
XcmI	CCA[ACGT][ACGT][ACGT][ACGT][ACGT][ACGT][ACGT][ACGT][ACGT]TGG	PALINDROME
